+--+--+--+--+--+--+--+--+
|  |        |        |  |
+  +G-+  +--+  +--+  +  +
|  |  |  |     |  G  G  |
+  +--+  +--+  +--+  +  +
|  |      04G03|     |  |
+  +G-+--+--+  +--+--+  +
|                    |  |
+--+--+--+--+  +--+  +  +
|  G        |  |  |  |  |
+--+  +G-+  +--+  +--+  +
|     |  |            01|
+--+--+--+--+--+--+--+G-+
|                     02|
+--+--+--+--+--+--+--+--+

01:8=ENTERED
01:2=GATE:EXIT
02:2=EXIT
03:4=LOCKED
04:6=LOCKED

START_DIRECTION=8
