+--+--+--+--+--+--+--+--+
|  |        |        |  |
+  +G-+  +--+  +--+  +  +
|  |  |  |     |  G  G  |
+  +--+  +--+  +--+  +  +
|  |        G  |     |  |
+  +G-+--+--+  +--+--+  +
|                    |  |
+--+--+--+--+  +--+  +  +
|  G        |  |  |  |  |
+--+  +G-+  +--+  +--+  +
|     |  |            01|
+--+--+--+--+--+--+--+G-+
|                     02|
+--+--+--+--+--+--+--+--+

01=START
02=EXIT

START_DIRECTION=8
