+--+--+--+--+--+--+--+--+
|05|        |        |  |
+  +G-+  +--+  +--+  +  +
|  |  |  |     |  G  G  |
+  +--+  +--+  +--+  +  +
|  |      04G03|     |  |
+  +G-+--+--+  +--+--+  +
|                    |  |
+--+--+--+--+  +--+  +  +
|  G        |  |  |  |  |
+--+  +G-+  +--+  +--+  +
|     |  |            01|
+--+--+--+--+--+--+--+G-+
|                     02|
+--+--+--+--+--+--+--+--+

01=START
02=EXIT
03:4=LOCKED
04:6=LOCKED
05:8=EVENT-0001

START_DIRECTION=8
